abdicate	quit
abdicated	quit
abdicates	quits
abdicating	quitting
abdomen	belly
abduct	kidnap
abducted	kidnapped
abducting	kidnapping
abducts	kidnaps
abeyance	waiting
abhor	hate
abhorred	hated
abhorring	hating
abhors	hates
abrasion	scratch
abrasions	scratches
abundant	enough
academies	schools
academy	school
academy's	school's
acceptable	welcome
accommodate	adjust
accommodated	fitted
accommodates	adjusts
accommodating	adjusting
accomplish	do
accomplished	did
accomplishing	doing
accorded	given
accordingly	so
accrual	addition
accruals	additions
accrue	add
accrued	added
accruement	addition
accrues	adds
accruing	adding
accumulate	collect
accumulates	collects
accurate	correct
accurately	exactly
accusation	charge
accusations	charges
achieve	do
achieved	did
achieves	does
achieving	doing
acquaintance	friend
acquaintances	friends
acquiesce	agree
acquiesced	agreed
acquiesces	agrees
acquiescing	agreeing
acquire	gain
acquired	gained
acquires	gains
acquiring	gaining
acrimonious	sharp
actual	real
actually	really
actuate	move
actuated	moved
actuates	moves
actuating	moving
adamant	hard
additional	added
additionally	added
adequate	enough
adhere	follow
adhered	followed
adheres	follows
adhering	following
administer	manage
administered	managed
administering	managing
administers	manages
admonish	warn
admonished	warned
admonishes	warns
admonishing	warning
admonition	warning
advantage	plus
advantageous	helpful
advantages	pluses
adversaries	enemies
adversary	enemy
adversary's	enemy's
adverse	harmful
adversities	difficulties
adversity	difficulty
advise	tell
advised	told
advises	tells
advising	telling
affable	pleasant
affectionate	loving
affix	put
affixed	put
affixes	puts
affixing	putting
affluent	rich
affray	fight
affrayed	fought
affraying	fighting
affrays	fights
aggregate	collect
aggregates	collects
aggressive	forward
agitate	shake
agitated	shook
agitates	shakes
agitating	shaking
aircraft	plane
aircraft's	plane's
aircrafts	planes
alacrity	speed
allay	quiet
allayed	quieted
allaying	quieting
allays	quiets
allocate	give
allotment	share
allotments	shares
allow	let
alter	change
alteration	change
alterations	changes
alternative	choice
alternatives	choices
amalgamated	united
ameliorate	improve
ameliorated	improved
ameliorates	improves
ameliorating	improving
amendment	change
amendments	changes
amongst	among
amusement	fun
analysis	review
analyze	review
analyzed	reviewed
analyzes	reviews
analyzing	reviewing
animadversion	blame
annihilate	kill
annihilated	killed
annihilates	kills
annihilating	killing
antagonist	enemy
antagonist's	enemy's
antagonists	enemies
anterior	front
anticipate	expect
anticipated	expected
anticipates	expects
anticipating	expecting
antipathy	dislike
anxieties	fears
anxiety	fear
aperture	hole
apertures	holes
apex	tip
apexes	tips
apparent	clear
apparition	ghost
apparition's	ghost's
apparitions	ghosts
appear	seem
appeared	seemed
appearing	seeming
appears	seems
appellation	name
appellations	names
append	add
appended	added
appending	adding
appends	adds
appoint	name
appointed	named
appointing	naming
appoints	names
apportion	divide
apportioned	divided
apportioning	dividing
apportions	divides
appreciable	many
apprise	tell
approbation	praise
approbations	praises
approval	praise
approximate	about
approximately	about
arbiter	judge
arbiters	judges
arduous	hard
aroma	smell
aromas	smells
ascend	climb
ascended	climbed
ascending	climbing
ascends	climbs
ascertain	learn
ascertained	learned
ascertaining	learning
ascertains	learns
aspiration	dream
aspirations	dreams
assassinate	kill
assassinated	killed
assassinates	kills
assassinating	killing
assassination	killing
assay	try
assayed	tried
assaying	trying
assays	tries
assemble	gather
assembled	gathered
assembles	gathers
assembling	gathering
assembly	meeting
assent	agree
assented	agreed
assenting	agreeing
assents	agrees
assist	aid
assistance	help
assistant	helper
assisted	aided
assisting	aiding
assists	aids
attain	reach
attained	reached
attaining	reaching
attains	reaches
attempt	try
attempted	tried
attempting	trying
attempts	tries
attire	dress
attractive	pleasing
audacious	bold
authentic	real
authentically	really
automaton	machine
automaton's	machine's
automatons	machines
automobile	car
automobile's	car's
automobiles	cars
available	offered
avaricious	greedy
avenue	road
avenue's	road's
avenues	roads
aversion	fear
aversions	dislikes
axiom	truth
axioms	truths
bargain	deal
bargains	deals
bashful	shy
beatitude	blessing
behemoth	giant
behemoths	giants
benediction	blessing
beneficence	kindness
beneficial	helpful
benefit	help
benefited	helped
benefits	helps
benefitted	helped
benefitting	helping
bereavement	loss
beseech	beg
beseeched	begged
beseeches	begs
beseeching	begging
besmirch	soil
bespeak	order
bespeaking	ordering
bespeaks	orders
bespoke	ordered
bestow	give
bestowed	gave
bestowing	giving
bestows	gives
bizarre	odd
boulevard	road
boulevard's	road's
boulevards	roads
burglar	robber
caitiff	coward
caitiffs	cowards
calculate	figure
capable	able
capacities	powers
capacity	power
captivate	charm
captivated	charmed
captivates	charms
captivating	charming
catalog	list
catalogs	lists
catalogue	list
catalogues	lists
categories	classes
categorise	class
categorises	classes
categorize	class
categorizes	classes
category	class
caveat	warning
cease	stop
censure	blame
censured	blamed
censures	blames
censuring	blaming
cessation	stop
cessations	stops
characterize	describe
characterized	described
characterizes	describes
characterizing	describing
charlatan	quack
charlatans	quacks
circumspect	careful
circumspectly	carefully
collection	heap
collections	heaps
colossal	large
combine	join
combined	joined
combines	joins
combining	joining
commence	start
commenced	started
commencement	start
commencements	starts
commences	starts
commencing	starting
commendation	praise
commendations	praises
commerce	trade
commiseration	pity
communicate	tell
companion	friend
companion's	mate's
companions	friends
compassion	pity
compensate	pay
compensated	paid
compensates	pays
compensating	paying
compensation	pay
competent	able
complied	followed
complies	follows
comply	follow
complying	following
component	part
component's	part's
components	parts
comprise	form
comprised	formed
comprises	forms
comprising	forming
conceal	hide
concealment	hiding
concept	idea
conception	thought
concerning	about
conclude	close
concluded	closed
concludes	closes
concluding	closing
conclusion	close
conclusive	final
conclusively	finally
concur	agree
concurred	agreed
concurring	agreeing
concurs	agrees
concussion	shock
concussions	shocks
confront	meet
confrontation	meeting
confronted	face
confronting	facing
confronts	faces
congeal	freeze
congealed	froze
congealing	freezing
congeals	freezes
congruous	fitting
conjecture	guess
conjectured	guessed
conjectures	guesses
conjecturing	guessing
consanguinity	blood
consequently	so
considerable	much
consolation	comfort
consolidate	join
consolidated	joined
consolidates	joins
consolidating	joining
constable	police
constable's	police's
constantly	always
constitute	be
constituted	was
constitutes	forms
constituting	being
constitution	form
construct	build
constructing	building
construction	building
construction's	building's
constructions	buildings
constructive	helpful
constructor	builder
constructor's	builder's
constructors	builders
constructs	builds
contain	have
contained	had
containing	having
contains	has
contemptible	mean
contiguous	touching
continue	keep
contort	twist
contorted	twisted
contorting	twisting
contorts	twists
contraption	machine
contraption's	machine's
contraptions	machines
contribute	give
contributed	gave
contributes	gives
contributing	giving
contribution	gift
contributions	gifts
contributor	giver
convene	meet
conversation	talk
conversations	talks
conversion	change
conversions	changes
convolution	fold
convolutions	folds
cooperate	help
cooperated	helped
cooperates	helps
cooperating	helping
cooperative	helpful
cooperator	helper
copious	plenty
corpulent	fat
corrugate	bend
corrugated	bent
corrugates	bends
corrugating	bending
corruption	rot
cozen	cheat
cozens	cheats
create	make
created	made
creates	makes
creating	making
culinarian	cook
culinarian's	cook's
culinarians	cooks
cultivate	grow
cultivated	grew
cultivates	grows
cultivating	growing
currently	now
customary	accepted
damsel	girl
damsels	girls
debilitate	weaken
debilitated	weakened
debilitates	weakens
debilitating	weakening
decentralize	scatter
decentralized	scattered
decentralizes	scatters
decentralizing	scattering
decrease	lower
deem	think
deemed	thought
deeming	thinking
deems	thinks
definitive	final
defunct	dead
delectable	pleasing
delete	cut
deleted	cut
deletes	cuts
deleting	cutting
deletion	cut
deletions	cuts
demise	death
demonstrate	show
demonstrated	showed
demonstrates	shows
demonstrating	showing
dense	thick
depart	leave
departed	left
departing	leaving
departs	leaves
deplete	empty
descending	downward
designate	name
designates	chooses
designating	choosing
desire	wish
desired	wished
desires	wishes
desiring	wishing
desist	stop
detain	hold
determine	decide
determined	decided
determines	decides
determining	deciding
detest	hate
detested	hated
detesting	hating
detests	hates
detrimental	harmful
develop	make
developed	made
developing	making
develops	makes
deviation	change
deviations	changes
dichotomies	groups
dichotomy	group
dichotomy's	group's
difficult	hard
difficulties	troubles
difficulty	trouble
disagreeable	cross
disclose	show
disclosed	shown
discloses	shows
disclosing	showing
discontinuance	dropping
discontinuances	stops
discontinuation	dropping
discontinuations	stop
discontinue	stop
discontinued	dropped
discontinues	drops
discontinuing	dropping
disengage	free
disentangle	free
dispatch	send
dispatched	sent
dispatches	sends
dispatching	sending
dispel	rid
dispelled	rid
dispelling	ridding
dispels	rids
disperse	scatter
dispersed	scattered
disperses	scatters
dispersing	scattering
disseminate	give
disseminated	scattered
dissimilar	different
dissipate	scatter
dissipated	scattered
dissipates	scatters
dissipating	scattering
dissolute	evil
divulge	tell
divulged	told
divulges	tells
divulging	telling
domesticate	tame
domesticated	tamed
domesticates	tames
domesticating	taming
domicile	home
domiciles	homes
donate	give
dormant	asleep
duplicate	copy
duplicated	copied
duplicates	copies
duplicating	copying
duration	time
eccentric	odd
echelon	level
echelon's	level's
echelons	levels
edifice	building
edifices	buildings
educator	teacher
effected	made
effecting	making
effusive	overflowing
elapse	pass
elect	choose
elected	picked
electing	choosing
elects	chooses
elevate	raise
elevated	rose
elevates	raises
elevating	raising
elevation	height
eliminate	cut
eliminated	cut
eliminates	cuts
eliminating	cutting
elongate	stretch
elongated	stretched
elongates	stretches
elongating	stretching
emancipate	free
emasculate	weaken
emasculated	weakened
emasculates	weakens
emasculating	weakening
eminent	high
employment	work
employments	uses
encounter	meet
encountered	met
encountering	meeting
endeavor	try
endeavored	tried
endeavoring	trying
endeavors	tries
endowment	gift
endowments	gifts
enervate	weaken
enervated	weakened
enervates	weakens
enervating	weakening
enigma	riddle
enigmas	riddles
enigmatic	puzzling
enjoin	order
enjoined	ordered
enjoining	ordering
enjoins	orders
enjoyable	fun
enmity	hate
enormous	large
entreat	beg
entreated	begged
entreating	begging
entreats	begs
enumerate	count
enumerated	counted
enumerates	counts
enumerating	counting
enumeration	count
enumerations	counts
enumerator	counter
enumerators	counters
epistle	letter
epistles	letters
equable	even
equine	horse
equine's	horse's
equines	horses
equitable	fair
equivalent	equal
erroneous	wrong
erudite	learned
establish	prove
established	proved
establishes	proves
establishing	proving
evaluate	check
evaluated	checked
evaluates	checks
evaluating	checking
evaluation	check
evaluations	checks
evaluators	checkers
evidenced	showed
evidences	shows
evidencing	showing
evident	clear
evince	show
examination	check
examinations	checks
examine	check
examined	checked
examines	checks
examining	checking
exceedingly	very
exchange	trade
exchanged	traded
exchanges	trades
exchanging	trading
execute	kill
executed	killed
executes	kills
executing	killing
execution	killing
exhibit	show
exhibiting	showing
exhibition	show
exhibitions	shows
exhibits	shows
exigency	need
exorbitant	large
expedite	hurry
expedited	hurried
expedites	hurries
expediting	hurrying
expeditious	fast
expeditiously	quickly
expend	spend
expended	spent
expending	spending
expends	spends
expense	cost
expenses	costs
expiration	end
explain	show
explained	showed
explaining	showing
explains	shows
explicit	clear
expunge	clear
exterior	outside
exterminate	kill
exterminated	killed
exterminates	kills
exterminating	killing
extermination	killing
external	outer
extricate	free
fabricate	build
fabricated	made
fabricates	builds
fabricating	building
facilitate	help
facilitates	helps
facilitating	helping
facilitation	help
fallacies	lies
fallacy	lie
familiar	known
famished	hungry
fatuous	silly
felonious	wicked
fetch	get
fetched	got
fetches	gets
fetching	getting
figurine	doll
figurine's	doll's
figurines	dolls
final	last
finalisation	finish
finalisations	finishes
finalise	finish
finalised	finished
finalises	finishes
finalising	finishing
finalization	finish
finalizations	finishes
finalize	complete
finalized	finished
finalizes	finishes
finalizing	finishing
firmament	sky
firstly	first
fluctuations	waves
forfeit	lose
forfeited	lost
forfeiting	losing
forfeits	loses
forfeiture	loss
formulate	plan
formulated	planned
formulates	plans
formulating	planning
frequently	often
frivolous	silly
function	act
functions	acts
furnish	give
furnished	gave
furnisher	giver
furnishes	gives
furnishing	giving
gargantuan	giant
general	broad
generate	make
generated	made
generates	makes
generating	making
genuine	real
genuinely	really
gigantic	huge
gloomy	sad
glutinous	sticky
grandiose	large
gratified	pleased
gratifies	pleases
gratify	please
gratifying	pleasing
gratuities	gifts
gratuity	gift
habitation	house
habitations	houses
hazardous	unsafe
hence	so
herein	here
herewith	below
however	but
humongous	giant
identical	same
identified	named
identifies	names
identify	find
identifying	naming
ignoble	base
illumination	light
illustrate	draw
illustrated	showed
illustrates	draws
illustrating	drawing
imbue	fill
imbued	filled
imbues	fills
imbuing	filling
immaculate	pure
immense	huge
imminent	near
immovable	fixed
impact	hit
impacted	hit
impacting	hitting
impacts	hits
impair	harm
impaired	weakened
impairing	weakening
impairs	weakens
impartial	fair
impecunious	poor
imperfection	fault
imperfections	faults
impinge	strike
impinged	hit
impinges	strikes
impinging	striking
implement	start
implemented	did
implementing	starting
implements	starts
impoverished	poor
inaccuracies	mistakes
inaccuracy	mistake
inadvertent	careless
inadvisable	unwise
inattentive	careless
inaugurate	begin
inaugurated	begun
inaugurates	begins
inaugurating	beginning
inception	start
inceptions	starts
incipient	beginning
incision	cut
incisions	cuts
incisive	cutting
inclement	stormy
incombustible	fireproof
inconsiderate	thoughtless
inconvenience	bother
inconveniences	bothers
incorporate	join
incorporated	joined
incorporates	joins
incorporating	joining
indelicate	rough
indemnifies	repays
indemnify	repay
indemnifying	repaying
indicate	show
indicated	shown
indicates	shows
indicating	showing
indication	sign
indication's	sign's
indications	signs
indigent	poor
individual	person
individuals	people
indolent	lazy
indubitable	certain
inexpedient	unwise
inferior	lesser
inferno	fire
inferno's	fire's
infernos	fires
infirmities	weaknesses
infirmity	weakness
inform	tell
ingenuous	open
iniquitous	wicked
initial	first
initialisation	start
initialisations	starts
initialise	start
initialised	started
initialises	starts
initialising	starting
initialization	start
initializations	starts
initialize	start
initialized	started
initializes	starts
initializing	starting
initiate	start
initiated	started
initiates	starts
initiating	starting
injudicious	unwise
innocuous	harmless
inoperative	broken
inquire	ask
inquired	asked
inquires	asks
inquiries	questions
inquiring	asking
inquiry	question
inquiry's	question's
insidious	sly
insinuate	hint
insinuated	hinted
insinuates	hints
insinuating	hinting
insinuation	hint
insinuations	hints
insipid	weak
institution	office
intelligent	smart
intention	plan
intentions	plans
interminable	endless
internal	inside
interrogate	question
interrogated	questioned
interrogates	questions
interrogating	questioning
interrogation	questioning
intimate	hint
intimated	hinted
intimates	hints
intimating	hinting
inundate	flood
inundated	flooded
inundates	floods
inundating	flooding
investigate	review
investigated	reviewed
investigates	reviews
investigating	reviewing
jocular	funny
jocund	happy
justifies	proves
justify	prove
justifying	proving
laceration	cut
lacerations	cuts
laggard	slow
laggardly	slowly
legislation	law
legislation's	law's
legislations	laws
legitimate	real
lethargic	dull
lethargically	dully
locate	find
located	found
locates	finds
locating	finding
location	place
locations	places
lucent	bright
lucid	clear
lugubrious	sad
luminous	bright
mademoiselle	lady
mademoiselle's	lady's
mademoiselles	ladies
magnitude	size
maintain	keep
maintained	kept
maintaining	keeping
maintains	keeps
majority	most
manner	way
manufacture	make
manufactured	made
manufactures	makes
manufacturing	making
marauder	robber
marionette	puppet
marionette's	puppet's
marionettes	puppets
massive	large
masticate	chew
masticated	chewed
masticates	chews
masticating	chewing
maximum	most
melancholy	sadness
mendacious	lying
mendicant	beggar
mendicants	beggars
mentality	mind
methodologies	designs
methodology	design
militate	fight
militated	fought
militates	fights
militating	fighting
minimum	smallest
miscellanies	mixtures
miscellany	mixture
modification	change
modifications	changes
modified	changed
modifies	changes
modify	change
modifying	changing
monitor	check
monitored	checked
monitoring	checking
monitors	checks
mordant	biting
motionless	still
mountainous	large
multiple	many
municipality	city
necessarily	needed
necessary	needed
necessitate	cause
necessitated	caused
necessitates	causes
necessitating	causing
necessity	need
neglectful	careless
nemesis	enemy
nemesis's	enemy's
notation	note
notations	notes
notification	notice
notifications	notices
notified	told
notifies	tells
notify	tell
notifying	telling
numerate	count
numerated	counted
numerates	counts
numerating	counting
numerous	many
nutriment	food
objective	aim
objectives	aims
obligate	bind
oblige	force
obliged	forced
obliges	forces
obliging	forcing
obliterate	erase
obliterated	erased
obliterates	erases
obliterating	erasing
oblivious	forgetful
obloquy	shame
obscured	hidden
observe	watch
observed	saw
observes	sees
observing	seeing
obstacle	problem
obstacle's	problem's
obstacles	problems
obstruct	block
obstructed	blocked
obstructing	blocking
obstruction	block
obstructions	blocks
obstructs	blocks
obtain	get
obtained	got
obtaining	getting
obtains	gets
occur	happen
occurred	happened
occurs	happens
odium	blame
ongoing	continuing
operate	run
operated	ran
operates	runs
operating	running
operational	working
opportunities	chances
opportunity	chance
optimum	best
option	choice
options	choices
opulent	rich
ordinance	rule
ordinances	rules
organisation's	company's
organisations	companies
organization's	company's
organizations	companies
orifice	opening
orifices	holes
ostentation	show
ostentations	shows
palatable	pleasing
paragon	model
paramount	top
parlance	talk
parlances	talks
peevish	cross
pendulous	hanging
penitent	sorry
perforation	hole
perforations	holes
perform	do
performing	doing
performs	does
permit	let
permitted	let
permitting	letting
perpetuity	forever
personnel	people
personnel's	people's
persons	people
perspicuous	clear
perspiration	sweat
peruse	review
perused	read
peruses	reads
perusing	reading
phantom	ghost
phantom's	ghost's
phantoms	ghosts
physician	doctor
physician's	doctor's
physicians	doctors
pinnacle	peak
plaintive	sad
plenary	full
plenteous	plenty
poignant	moving
poltergeist	ghost
poltergeist's	ghost's
poltergeists	ghosts
portion	part
portion's	part's
portions	parts
position	place
positions	places
possess	have
possessed	had
possesses	has
possessing	having
posterior	rear
precept	rule
precepts	rules
precipitation	rain
preclude	prevent
precluded	prevented
precludes	prevents
precluding	preventing
predicament	problem
predicament's	problem's
predicaments	problems
predilection	liking
preeminent	top
preferable	better
preponderant	major
prescribed	set
presently	now
presumptuous	bold
prevaricate	lie
prevaricated	lied
prevaricates	lies
prevaricating	lying
previous	earlier
previously	before
primary	first
prior	earlier
probabilities	chances
probability	chance
procedure	rule
procedures	rules
proceed	do
proceeding	doing
proceeds	does
procure	get
prodigious	huge
produced	made
produces	makes
producing	making
proffer	offer
proffered	offered
proffering	offering
proffers	offers
profound	deep
progeny	children
program	plan
promulgate	announce
promulgated	announced
promulgates	announces
promulgating	announcing
promulgation	announcement
proscribe	outlaw
proscribes	outlaws
provide	give
puissance	power
punctilious	exact
punctiliously	exactly
pungent	bitter
purchase	buy
purchased	bought
purchaser	buyer
purchases	buys
purchasing	buying
purloin	steal
purloined	stole
purloining	stealing
purloins	steals
pursuit	chase
pusillanimous	frightened
putrefaction	rot
quandaries	problems
quandary	problem
quandary's	problem's
quantify	measure
quarrelsome	cross
quiescent	still
radiant	bright
ramification	branch
ramifications	branches
rapid	quick
rapidly	quickly
recondite	hidden
reduce	cut
reduced	cut
reduces	cuts
reducing	cutting
reduction	cut
reductions	cuts
reflect	say
regarding	about
regimen	rule
regulation	rule
regulations	rules
relocate	move
relocated	moved
relocates	moves
relocating	moving
relocation	move
relocations	moves
remain	stay
remainder	rest
remained	stayed
remaining	staying
remains	stays
remedies	cures
remedy	cure
remunerate	pay
remunerated	paid
remunerates	pays
remunerating	paying
remuneration	pay
remunerations	pays
replica	copy
replicas	copies
reprehend	blame
reprehended	blamed
reprehending	blaming
reprehends	blames
represents	is
repugnance	dislike
request	ask
requested	asked
requesting	asking
requests	asks
require	need
required	needed
requirement	need
requirements	needs
requires	needs
requiring	needing
requisite	needed
reside	live
residence	house
residences	houses
respond	answer
responsibilities	jobs
responsibility	job
retain	keep
retained	kept
retaining	keeping
retains	keeps
retention	keeping
reticent	silent
reversion	return
review	check
reviewed	checked
reviewing	checking
reviews	checks
risible	funny
rubicund	red
saccharine	sweet
sagacious	wise
salient	important
salutation	greeting
sanitary	clean
satisfied	happy
saturate	soak
saturated	soaked
saturates	soaks
saturating	soaking
scandalous	shocking
sebaceous	greasy
secondly	second
segment	part
segments	parts
segregate	separate
selection	choice
serpentine	twisting
shortly	soon
similar	like
solicitous	eager
solitary	alone
specter	ghost
specter's	ghost's
specters	ghosts
speculate	reflect
speculated	reflected
speculates	reflects
speculating	reflecting
state-of-the-art	latest
strategies	plans
strategy	plan
stringent	tight
submit	give
submits	sends
submitted	sent
submitter	giver
submitting	sending
subsequent	later
subsequently	later
substantial	real
substantially	really
substantiate	prove
substantiated	proved
substantiates	proves
substantiating	proving
subterfuge	trick
sufficient	enough
sumptuous	rich
superior	better
superlative	excellent
supplemental	added
surreptitious	secret
tabulation	table
tabulations	tables
tantalize	tease
tantalized	teased
tantalizes	teases
tantalizing	teasing
tempestuous	stormy
tenuous	thin
terminate	end
terminated	ended
terminates	ends
terminating	ending
terminus	end
tertiary	third
thereafter	then
therefore	so
therein	there
thereof	its
therewith	with
thirdly	third
thoroughfare	road
thoroughfare's	road's
thoroughfares	roads
titillate	tickle
titillated	tickled
titillates	tickles
titillating	tickling
transcription	copy
transcriptions	copies
transmit	send
transmits	sends
transmitted	sent
transmitting	sending
transparent	clear
transpiration	happening
transpire	happen
transpired	happened
transpires	happens
transpiring	happening
trenchant	sharp
trepidation	fear
trepidations	fears
tribulation	trouble
tribulations	troubles
tributaries	rivers
tributary	river
tributary's	river's
typically	often
ulterior	hidden
uncivilized	savage
uncultivated	wild
undulations	curves
unequivocal	clear
unfamiliar	unknown
upon	on
usually	often
utilisabilities	uses
utilisation	use
utilisations	uses
utilise	use
utilised	used
utilises	uses
utilising	using
utilities	tools
utility	tool
utility's	tool's
utilizabilities	uses
utilization	use
utilizations	uses
utilize	use
utilized	used
utilizes	uses
utilizing	using
vacuous	empty
validity	truth
valorous	brave
value	cost
variation	change
variations	changes
vehement	eager
velocity	speed
venturous	bold
verbatim	exact
verification	proof
vertically	upward
via	in
vindicate	defend
vindicated	defended
vindicates	defends
vindicating	defending
visualize	picture
visualized	pictured
visualizes	pictures
visualizing	picturing
vociferate	shout
vociferated	shouted
vociferates	shouts
vociferating	shouting
voluminous	large
whenever	when
whereas	because
whilst	while
witnessed	saw
