a	ADJECTIVE
about	PREPOSITION
after	PREPOSITION
again	ADVERB
all	ADJECTIVE
always	ADVERB
am	VERB
an	ADJECTIVE
and	CONJUNCTION
any	ADJECTIVE
apple	NOUN
are	VERB
around	ADVERB
as	CONJUNCTION
ask	VERB
at	PREPOSITION
ate	VERB
away	ADVERB
baby	NOUN
back	NOUN
ball	NOUN
be	VERB
bear	NOUN
because	CONJUNCTION
bed	NOUN
been	VERB
before	ADVERB
bell	NOUN
best	ADJECTIVE
better	ADJECTIVE
big	ADJECTIVE
bird	NOUN
birthday	NOUN
black	ADJECTIVE
blue	ADJECTIVE
boat	NOUN
both	ADJECTIVE
box	NOUN
boy	NOUN
bread	NOUN
bring	VERB
brother	NOUN
brown	ADJECTIVE
but	CONJUNCTION
buy	VERB
by	PREPOSITION
cake	NOUN
call	VERB
came	VERB
can	VERB
car	NOUN
carry	VERB
cat	NOUN
chair	NOUN
chicken	NOUN
children	NOUN
christmas	NOUN
claus	NOUN
clean	ADJECTIVE
coat	NOUN
cold	ADJECTIVE
come	VERB
corn	NOUN
could	VERB
cow	NOUN
cut	VERB
day	NOUN
did	VERB
do	VERB
does	VERB
dog	NOUN
doll	NOUN
done	VERB
don't	VERB
door	NOUN
down	PREPOSITION
draw	VERB
drink	VERB
duck	NOUN
eat	VERB
egg	NOUN
eight	ADJECTIVE
every	ADJECTIVE
eye	NOUN
fall	VERB
far	ADVERB
farm	NOUN
farmer	NOUN
fast	ADVERB
father	NOUN
feet	NOUN
find	VERB
fire	NOUN
first	ADVERB
fish	NOUN
five	ADJECTIVE
floor	NOUN
flower	NOUN
fly	VERB
for	PREPOSITION
found	VERB
four	ADJECTIVE
from	PREPOSITION
full	ADJECTIVE
funny	ADJECTIVE
game	NOUN
garden	NOUN
gave	VERB
get	VERB
girl	NOUN
give	VERB
go	VERB
goes	VERB
going	VERB
good	ADJECTIVE
goodbye	NOUN
got	VERB
grass	NOUN
green	ADJECTIVE
ground	NOUN
grow	VERB
had	VERB
hand	NOUN
has	VERB
have	VERB
he	PRONOUN
head	NOUN
help	VERB
her	PRONOUN
here	ADVERB
hill	NOUN
him	PRONOUN
his	PRONOUN
hold	VERB
home	NOUN
horse	NOUN
hot	ADJECTIVE
house	NOUN
how	ADVERB
hurt	VERB
I	PRONOUN
if	CONJUNCTION
in	PREPOSITION
into	PREPOSITION
is	VERB
it	PRONOUN
its	PRONOUN
jump	VERB
just	ADVERB
keep	VERB
kind	ADJECTIVE
kitty	NOUN
know	VERB
laugh	VERB
leg	NOUN
let	VERB
letter	NOUN
light	ADJECTIVE
like	VERB
little	ADJECTIVE
live	VERB
long	ADJECTIVE
look	VERB
made	VERB
make	VERB
man	NOUN
many	ADJECTIVE
may	VERB
me	PRONOUN
men	NOUN
milk	NOUN
money	NOUN
morning	NOUN
mother	NOUN
much	ADVERB
must	VERB
my	PRONOUN
myself	PRONOUN
name	NOUN
nest	NOUN
never	ADVERB
new	ADJECTIVE
night	NOUN
no	ADVERB
not	ADVERB
now	ADVERB
of	PREPOSITION
off	ADVERB
old	ADJECTIVE
on	PREPOSITION
once	ADVERB
one	ADJECTIVE
only	ADVERB
open	VERB
or	CONJUNCTION
our	PRONOUN
out	ADVERB
over	PREPOSITION
own	ADJECTIVE
paper	NOUN
party	NOUN
pick	VERB
picture	NOUN
pig	NOUN
play	VERB
please	VERB
pretty	ADJECTIVE
pull	VERB
put	VERB
rabbit	NOUN
rain	NOUN
ran	VERB
read	VERB
red	ADJECTIVE
ride	VERB
right	ADJECTIVE
ring	NOUN
robin	NOUN
round	ADJECTIVE
run	VERB
said	VERB
santa	NOUN
saw	VERB
say	VERB
school	NOUN
see	VERB
seed	NOUN
seven	ADJECTIVE
shall	VERB
she	PRONOUN
sheep	NOUN
shoe	NOUN
show	VERB
sing	VERB
sister	NOUN
sit	VERB
six	ADJECTIVE
sleep	VERB
small	ADJECTIVE
snow	NOUN
so	ADVERB
some	ADJECTIVE
song	NOUN
soon	ADVERB
squirrel	NOUN
start	VERB
stock	NOUN
stop	VERB
street	NOUN
sun	NOUN
table	NOUN
take	VERB
tell	VERB
ten	ADJECTIVE
thank	VERB
that	PRONOUN
the	ADJECTIVE
their	PRONOUN
them	PRONOUN
then	ADVERB
there	ADVERB
these	PRONOUN
they	PRONOUN
thing	NOUN
think	VERB
this	PRONOUN
those	PRONOUN
three	ADJECTIVE
time	NOUN
to	PREPOSITION
today	ADVERB
together	ADVERB
too	ADVERB
top	NOUN
toy	NOUN
tree	NOUN
try	VERB
two	ADJECTIVE
under	PREPOSITION
up	ADVERB
upon	PREPOSITION
us	PRONOUN
use	VERB
very	ADVERB
walk	VERB
want	VERB
warm	ADJECTIVE
was	VERB
wash	VERB
watch	NOUN
water	NOUN
way	NOUN
we	PRONOUN
well	ADVERB
went	VERB
were	VERB
what	PRONOUN
when	ADVERB
where	ADVERB
which	PRONOUN
white	ADJECTIVE
who	PRONOUN
why	ADVERB
will	VERB
wind	NOUN
window	NOUN
wish	VERB
with	PREPOSITION
wood	NOUN
work	VERB
would	VERB
write	VERB
yellow	ADJECTIVE
yes	ADVERB
you	PRONOUN
your	PRONOUN